collapse	折り畳む	origin: Eijiro
shared memory	共有メモリ
socket	ソケット
applet	アプレット
refactoring	リファクタリング
interface	インターフェイス
implement	実装
subtype	サブタイプ
postfix	接尾辞
prefix	接頭辞
paired braces	中括弧
paired brackets	大括弧	[ ]
paired parens	小括弧	( )
paired parens	小括弧	( )
Project	プロジェクト
Package	パッケージ
constructor	コンストラクタ
method	メソッド
object	オブジェクト
type	タイプ
default	デフォルト	ex. default package デフォルトパッケージ
implicit	暗黙的な
parameter	パラメータ
annotate	注釈
API	API
override	オーバーライド
derivable	派生
cast	キャスト
